Shape checking X_test image: (702, 64, 64, 3)
Shape checking X_train image: (7, 64, 64, 3)
Prediction_labels: [3 4 0 2 2 2 3 0 2 2 2 2 3 2 4 4 4 4 4 3 3 4 3 2 2 2 3 3 3 2 2 3 2 2 4 2 2
 3 2 4 4 2 4 2 3 3 4 2 2 2 3 3 2 2 2 3 3 3 2 2 2 2 2 4 3 0 3 1 4 2 4 3 4 2
 3 2 2 3 4 0 2 4 2 3 2 4 3 2 3 2 4 2 3 4 2 0 2 1 2 2 2 3 4 2 3 3 3 3 2 2 2
 2 2 4 3 2 2 2 2 2 2 2 2 2 4 4 2 2 2 2 3 2 2 4 3 4 3 2 2 4 3 2 3 4 2 4 2 3
 3 2 2 0 3 0 2 4 2 2 2 2 2 4 2 4 2 2 3 4 4 4 2 2 3 4 4 3 2 3 4 3 3 2 2 2 0
 3 4 4 3 2 3 4 2 3 4 2 2 4 3 4 2 3 0 2 4 4 3 3 3 4 2 4 3 3 2 2 4 3 2 2 3 2
 2 2 3 3 3 3 2 2 1 2 3 2 2 3 4 2 3 0 4 4 3 4 3 2 3 4 4 3 2 2 2 4 2 2 4 3 2
 3 0 2 2 2 4 4 3 3 3 1 2 4 3 4 4 4 3 1 2 2 4 3 4 4 0 4 3 2 3 2 3 2 4 4 2 4
 2 3 2 3 3 3 2 2 4 2 2 2 2 2 4 2 3 2 2 2 4 4 2 4 2 2 2 4 3 3 2 4 3 3 2 2 2
 2 3 2 1 2 4 2 4 4 2 4 2 2 4 3 2 3 4 3 3 4 2 2 4 3 4 3 2 2 3 2 3 3 0 2 3 2
 2 4 3 2 3 2 2 2 4 3 2 2 3 2 2 4 4 2 3 2 2 2 2 2 3 3 2 2 4 4 2 2 2 3 2 2 2
 3 0 3 2 4 2 3 2 2 2 2 3 3 2 3 4 2 2 2 3 2 0 3 0 2 3 2 2 2 3 3 4 1 4 2 2 2
 2 2 3 3 3 2 0 3 2 2 2 2 2 3 4 3 2 3 2 4 0 3 3 3 3 3 0 3 2 2 3 2 3 0 3 2 0
 3 2 3 2 2 3 2 4 3 2 4 3 2 3 3 4 3 3 2 2 4 3 2 2 3 2 2 4 3 3 4 2 2 2 2 2 3
 3 4 2 2 4 3 2 2 2 2 2 2 2 2 2 3 3 2 2 0 4 2 4 2 2 2 3 4 2 3 3 2 3 2 3 4 2
 3 3 3 4 2 3 4 3 2 3 2 2 2 4 3 2 4 3 3 4 4 0 2 4 3 2 2 2 2 3 3 4 2 3 2 3 2
 0 2 2 2 3 2 4 2 4 4 4 3 4 2 3 2 2 2 3 3 3 2 2 2 3 4 3 3 4 2 2 2 2 3 2 4 2
 2 3 2 4 3 4 3 3 4 3 4 2 2 2 3 2 4 3 3 3 3 4 3 4 2 3 3 2 4 2 2 2 3 3 2 2 2
 0 3 4 2 2 4 2 4 4 3 3 3 4 4 3 3 2 3 2 3 3 3 3 3 3 2 3 2 2 2 3 3 2 2 3 4]
Test_labels: [3 4 0 0 2 2 3 0 2 0 2 2 3 2 4 4 0 4 1 3 3 1 3 4 2 0 3 3 2 3 2 3 2 2 0 4 0
 3 2 0 1 2 0 2 3 3 4 2 2 2 3 3 2 2 0 3 3 3 2 2 4 0 4 4 2 0 3 1 4 2 4 3 4 2
 3 2 2 3 4 0 0 4 3 0 3 0 3 3 3 2 4 3 0 4 2 0 2 2 2 2 4 3 0 0 3 3 3 3 3 2 2
 2 2 4 3 2 2 2 2 0 2 2 2 2 4 4 2 2 4 2 3 2 2 4 3 4 3 2 2 4 3 2 3 4 2 4 2 3
 3 2 0 0 3 0 2 4 2 2 0 2 2 4 2 4 2 2 3 1 0 4 2 4 3 1 4 3 2 3 4 3 4 2 2 0 0
 2 4 0 3 2 3 4 0 0 4 2 2 4 3 4 2 3 0 2 4 4 3 3 3 4 2 0 3 3 2 2 4 3 0 4 3 0
 2 0 3 3 3 3 2 4 0 0 3 2 2 3 4 2 3 0 0 4 3 4 3 4 3 1 4 3 4 2 2 1 2 0 0 3 2
 3 0 2 2 2 4 4 3 2 3 1 0 4 3 4 4 4 3 4 0 4 4 3 0 0 0 4 3 2 3 2 3 2 1 4 2 4
 4 3 2 3 3 3 2 4 4 2 0 2 2 2 4 2 3 2 2 4 4 4 2 4 2 2 2 4 3 3 2 4 3 4 2 4 3
 2 3 2 3 2 0 2 4 4 2 4 0 4 4 3 2 3 4 0 0 4 2 2 4 3 4 3 2 2 3 2 3 3 0 2 3 2
 2 0 0 2 3 2 2 4 4 3 2 2 3 2 2 4 4 2 3 2 2 4 2 2 3 0 2 2 0 4 4 0 0 3 4 2 0
 0 0 3 3 4 2 0 2 2 2 2 3 3 2 3 2 2 2 2 3 0 0 3 0 2 3 2 2 4 3 3 4 4 4 0 2 2
 2 4 3 3 3 0 3 3 2 0 2 0 2 3 4 3 2 3 2 4 0 3 0 3 3 3 0 3 2 2 3 2 3 0 3 2 0
 3 4 3 2 0 3 2 1 3 2 4 3 2 3 3 4 3 3 2 2 4 3 0 2 3 2 2 4 3 3 4 4 2 2 2 2 3
 3 4 2 2 0 3 1 2 2 2 2 2 2 0 4 3 3 4 0 0 0 4 4 2 3 2 3 4 2 3 3 2 3 2 3 4 2
 3 3 3 4 2 3 1 3 0 3 4 2 0 4 3 2 4 3 3 4 2 0 2 1 3 2 2 2 2 3 3 0 2 3 2 3 2
 0 4 2 2 3 4 4 2 4 4 4 3 4 4 3 2 0 0 3 0 3 2 2 2 3 4 3 3 4 2 2 2 2 3 2 4 4
 2 3 1 1 3 4 3 3 1 3 4 2 2 2 3 2 4 3 3 3 3 4 3 1 2 3 3 2 0 2 2 0 3 3 3 0 2
 0 3 4 0 2 4 2 4 4 3 3 2 0 4 3 3 4 3 0 3 3 3 3 3 2 4 3 0 1 2 3 3 2 2 3 4]
Model classification result -> 0.782051282051282 ||| Model classification loss -> 0.21794871794871795
Shape checking X_test image: (702, 64, 64, 3)
Shape checking X_train image: (7, 64, 64, 3)
Prediction_labels: [4 3 4 0 0 0 0 4 3 4 2 4 0 0 4 4 2 4 2 0 4 0 2 0 3 2 2 4 0 2 0 2 2 2 2 3 2
 2 3 2 2 2 2 2 2 2 2 3 2 2 2 3 0 2 2 2 2 2 3 2 2 3 0 2 2 2 2 2 2 0 4 2 2 2
 0 2 2 0 0 2 0 1 4 0 4 0 0 4 0 3 4 2 2 4 4 2 4 4 4 1 4 4 4 1 4 4 4 4 4 4 2
 4 4 4 2 2 2 2 2 2 2 2 2 2 2 3 2 2 2 2 2 2 2 2 2 2 2 2 2 2 2 2 2 2 2 2 2 2
 2 2 2 2 2 2 2 2 2 2 2 2 2 2 2 2 2 2 2 2 2 2 2 2 2 2 2 2 2 2 2 2 2 2 2 2 2
 2 2 2 2 2 2 2 3 2 2 4 2 2 2 2 2 2 2 2 2 2 2 2 2 2 2 2 2 2 2 2 2 2 2 2 2 2
 2 2 2 2 2 2 2 2 2 2 2 2 2 2 2 2 2 2 2 2 2 2 2 2 2 2 2 2 3 2 2 2 2 2 2 2 2
 2 2 2 2 2 2 2 2 2 2 4 2 2 2 2 2 2 2 1 2 2 2 2 2 2 2 2 2 2 2 2 2 2 2 2 2 2
 2 2 3 2 2 2 2 2 2 2 2 2 2 2 2 2 2 2 2 2 2 2 2 2 2 2 2 2 2 2 2 2 2 2 2 2 3
 2 2 2 2 2 2 2 2 2 2 2 2 2 3 2 3 3 3 2 3 3 3 2 3 3 3 3 3 2 3 3 3 3 3 2 3 3
 3 3 3 3 3 3 3 3 3 3 3 3 3 3 3 3 3 3 3 3 3 3 3 2 3 3 3 3 3 3 3 3 3 3 3 3 3
 3 3 3 3 3 3 3 3 3 3 3 3 2 3 3 3 3 3 3 3 3 3 3 3 3 3 3 3 3 3 3 3 3 3 3 3 3
 3 3 3 3 3 3 3 3 3 3 0 3 3 3 3 3 3 3 3 3 3 3 3 2 3 3 3 3 3 3 3 3 3 3 3 3 3
 3 3 3 3 3 3 3 3 3 3 3 3 3 3 3 3 3 3 3 3 3 3 3 3 3 3 3 3 3 3 1 3 3 3 3 3 3
 3 3 3 3 3 3 3 3 3 3 3 3 3 3 3 3 3 3 3 3 3 3 3 3 3 3 3 2 3 3 3 3 3 3 3 2 3
 3 3 2 4 1 4 4 2 4 4 4 2 2 2 4 4 2 4 4 2 4 4 4 2 4 4 4 4 1 4 2 4 2 4 4 2 2
 4 4 4 2 4 2 4 4 2 4 2 4 4 4 2 2 4 4 4 4 4 2 4 4 4 4 4 4 4 4 2 2 2 4 4 4 4
 2 4 4 4 4 4 2 4 2 2 4 4 2 4 4 2 3 4 4 4 2 4 4 4 4 4 4 4 4 4 4 2 4 4 4 4 4
 3 4 4 4 4 4 4 4 4 4 2 4 4 4 4 4 4 4 4 4 4 2 4 2 2 4 4 4 4 4 4 2 4 4 4 4]
Test_labels: [0 0 0 0 0 0 0 0 0 0 0 0 0 0 0 0 0 0 0 0 0 0 0 0 0 0 0 0 0 0 0 0 0 0 0 0 0
 0 0 0 0 0 0 0 0 0 0 0 0 0 0 0 0 0 0 0 0 0 0 0 0 0 0 0 0 0 0 0 0 0 0 0 0 0
 0 0 0 0 0 0 0 0 0 0 0 0 0 0 0 0 0 0 0 0 0 1 1 1 1 1 1 1 1 1 1 1 1 1 1 1 1
 1 1 1 1 2 2 2 2 2 2 2 2 2 2 2 2 2 2 2 2 2 2 2 2 2 2 2 2 2 2 2 2 2 2 2 2 2
 2 2 2 2 2 2 2 2 2 2 2 2 2 2 2 2 2 2 2 2 2 2 2 2 2 2 2 2 2 2 2 2 2 2 2 2 2
 2 2 2 2 2 2 2 2 2 2 2 2 2 2 2 2 2 2 2 2 2 2 2 2 2 2 2 2 2 2 2 2 2 2 2 2 2
 2 2 2 2 2 2 2 2 2 2 2 2 2 2 2 2 2 2 2 2 2 2 2 2 2 2 2 2 2 2 2 2 2 2 2 2 2
 2 2 2 2 2 2 2 2 2 2 2 2 2 2 2 2 2 2 2 2 2 2 2 2 2 2 2 2 2 2 2 2 2 2 2 2 2
 2 2 2 2 2 2 2 2 2 2 2 2 2 2 2 2 2 2 2 2 2 2 2 2 2 2 2 2 2 2 2 2 2 2 2 2 2
 2 2 2 2 2 2 2 2 2 2 2 2 2 2 3 3 3 3 3 3 3 3 3 3 3 3 3 3 3 3 3 3 3 3 3 3 3
 3 3 3 3 3 3 3 3 3 3 3 3 3 3 3 3 3 3 3 3 3 3 3 3 3 3 3 3 3 3 3 3 3 3 3 3 3
 3 3 3 3 3 3 3 3 3 3 3 3 3 3 3 3 3 3 3 3 3 3 3 3 3 3 3 3 3 3 3 3 3 3 3 3 3
 3 3 3 3 3 3 3 3 3 3 3 3 3 3 3 3 3 3 3 3 3 3 3 3 3 3 3 3 3 3 3 3 3 3 3 3 3
 3 3 3 3 3 3 3 3 3 3 3 3 3 3 3 3 3 3 3 3 3 3 3 3 3 3 3 3 3 3 3 3 3 3 3 3 3
 3 3 3 3 3 3 3 3 3 3 3 3 3 3 3 3 3 3 3 3 3 3 3 3 3 3 3 3 3 3 3 3 3 3 3 3 3
 3 3 4 4 4 4 4 4 4 4 4 4 4 4 4 4 4 4 4 4 4 4 4 4 4 4 4 4 4 4 4 4 4 4 4 4 4
 4 4 4 4 4 4 4 4 4 4 4 4 4 4 4 4 4 4 4 4 4 4 4 4 4 4 4 4 4 4 4 4 4 4 4 4 4
 4 4 4 4 4 4 4 4 4 4 4 4 4 4 4 4 4 4 4 4 4 4 4 4 4 4 4 4 4 4 4 4 4 4 4 4 4
 4 4 4 4 4 4 4 4 4 4 4 4 4 4 4 4 4 4 4 4 4 4 4 4 4 4 4 4 4 4 4 4 4 4 4 4]
Model classification result -> 0.7849002849002849 ||| Model classification loss -> 0.2150997150997151
Model Test loss -> 0.8971086144447327 , Model Test accuracy -> 0.7849003076553345
Confusion Matrix -> 
[[ 22   1  45  10  17]
 [  0   2   3   0  15]
 [  0   1 223   6   2]
 [  1   1  10 198   0]
 [  0   2  35   2 106]]
Shape checking X_test image: (696, 64, 64, 3)
Shape checking X_train image: (7, 64, 64, 3)
Prediction_labels: [2 0 2 1 2 2 0 2 0 0 4 0 1 0 3 4 0 0 2 2 4 0 0 0 0 1 0 0 0 0 2 1 2 0 0 4 2
 0 0 2 4 2 4 0 4 2 0 4 2 3 4 2 2 2 2 2 1 4 4 4 1 4 4 1 4 4 2 2 2 4 4 1 4 2
 2 4 4 4 1 4 1 2 2 2 2 2 1 4 1 4 1 2 4 4 1 4 2 2 2 2 2 2 2 2 2 2 2 2 2 2 2
 2 2 2 2 2 1 2 2 2 2 2 2 2 2 2 2 2 2 2 2 2 4 2 2 2 2 2 2 2 2 2 2 2 2 3 2 2
 2 2 2 2 2 2 2 2 2 2 2 2 2 2 2 2 2 2 2 2 2 2 2 2 2 2 2 2 2 2 2 2 2 2 2 2 2
 2 2 2 2 2 2 2 2 2 2 2 2 2 1 2 2 2 2 2 2 2 2 2 2 2 2 2 2 2 2 1 2 2 2 2 2 2
 2 2 2 2 2 2 2 2 2 2 2 2 2 2 2 2 2 2 2 2 2 2 2 2 2 2 2 2 2 2 2 2 2 2 2 2 2
 2 2 2 2 2 2 2 2 2 2 2 2 2 2 2 2 2 0 2 2 2 2 2 2 2 2 2 2 2 1 2 2 2 2 2 2 2
 2 2 2 2 2 2 2 2 2 2 2 2 2 2 2 2 2 2 2 2 2 2 2 2 2 2 2 2 2 2 2 2 1 2 2 2 2
 2 2 2 2 2 2 2 2 2 2 2 2 2 2 2 2 2 2 2 2 2 2 2 1 2 2 2 2 2 2 2 2 2 2 2 2 2
 2 2 2 2 2 2 2 2 2 4 2 2 2 2 2 2 2 2 2 2 2 2 2 2 2 2 2 2 2 2 2 2 2 2 2 2 2
 2 2 2 2 2 2 2 2 2 2 2 2 2 2 2 2 2 2 2 3 3 3 3 2 2 2 3 3 3 3 2 3 3 3 2 2 3
 3 3 3 2 2 3 2 2 3 3 3 3 3 3 3 2 2 2 3 3 2 2 3 3 2 2 3 3 2 2 3 3 2 3 3 3 3
 3 3 3 3 2 2 2 2 3 3 2 3 2 2 2 3 3 3 3 3 3 3 3 3 3 2 2 3 3 2 2 3 3 3 3 3 3
 3 3 2 2 3 2 2 3 2 2 2 3 3 2 2 2 3 3 3 3 2 2 3 3 3 3 3 2 2 3 3 4 4 3 4 2 4
 2 4 4 4 4 4 4 2 2 2 2 4 4 4 2 4 2 2 4 4 4 4 4 4 4 4 2 4 4 4 2 4 4 4 3 2 4
 4 4 4 4 4 4 4 4 4 4 4 2 4 4 4 4 3 4 4 4 4 4 4 4 4 4 4 3 4 4 4 4 3 4 4 4 4
 4 4 4 4 3 4 4 4 4 3 4 4 4 4 4 3 4 4 4 2 4 4 4 2 4 2 4 4 4 4 4 4 2 4 4 4 3
 4 2 4 4 4 4 2 2 4 4 4 2 2 4 4 4 4 2 4 4 4 3 4 4 4 4 4 4 4 4]
Test_labels: [0 0 0 0 0 0 0 0 0 0 0 0 0 0 0 0 0 0 0 0 0 0 0 0 0 0 0 0 0 0 0 0 0 0 0 0 0
 0 0 0 0 0 0 0 0 0 0 0 0 0 0 0 0 0 0 0 0 1 1 1 1 1 1 1 1 1 1 1 1 1 1 1 1 1
 1 1 1 1 1 1 1 1 1 1 1 1 1 1 1 1 1 1 1 1 1 1 1 1 2 2 2 2 2 2 2 2 2 2 2 2 2
 2 2 2 2 2 2 2 2 2 2 2 2 2 2 2 2 2 2 2 2 2 2 2 2 2 2 2 2 2 2 2 2 2 2 2 2 2
 2 2 2 2 2 2 2 2 2 2 2 2 2 2 2 2 2 2 2 2 2 2 2 2 2 2 2 2 2 2 2 2 2 2 2 2 2
 2 2 2 2 2 2 2 2 2 2 2 2 2 2 2 2 2 2 2 2 2 2 2 2 2 2 2 2 2 2 2 2 2 2 2 2 2
 2 2 2 2 2 2 2 2 2 2 2 2 2 2 2 2 2 2 2 2 2 2 2 2 2 2 2 2 2 2 2 2 2 2 2 2 2
 2 2 2 2 2 2 2 2 2 2 2 2 2 2 2 2 2 2 2 2 2 2 2 2 2 2 2 2 2 2 2 2 2 2 2 2 2
 2 2 2 2 2 2 2 2 2 2 2 2 2 2 2 2 2 2 2 2 2 2 2 2 2 2 2 2 2 2 2 2 2 2 2 2 2
 2 2 2 2 2 2 2 2 2 2 2 2 2 2 2 2 2 2 2 2 2 2 2 2 2 2 2 2 2 2 2 2 2 2 2 2 2
 2 2 2 2 2 2 2 2 2 2 2 2 2 2 2 2 2 2 2 2 2 2 2 2 2 2 2 2 2 2 2 2 2 2 2 2 2
 2 2 2 2 2 2 2 2 2 2 2 2 2 2 2 2 2 2 2 3 3 3 3 3 3 3 3 3 3 3 3 3 3 3 3 3 3
 3 3 3 3 3 3 3 3 3 3 3 3 3 3 3 3 3 3 3 3 3 3 3 3 3 3 3 3 3 3 3 3 3 3 3 3 3
 3 3 3 3 3 3 3 3 3 3 3 3 3 3 3 3 3 3 3 3 3 3 3 3 3 3 3 3 3 3 3 3 3 3 3 3 3
 3 3 3 3 3 3 3 3 3 3 3 3 3 3 3 3 3 3 3 3 3 3 3 3 3 3 3 3 3 3 3 4 4 4 4 4 4
 4 4 4 4 4 4 4 4 4 4 4 4 4 4 4 4 4 4 4 4 4 4 4 4 4 4 4 4 4 4 4 4 4 4 4 4 4
 4 4 4 4 4 4 4 4 4 4 4 4 4 4 4 4 4 4 4 4 4 4 4 4 4 4 4 4 4 4 4 4 4 4 4 4 4
 4 4 4 4 4 4 4 4 4 4 4 4 4 4 4 4 4 4 4 4 4 4 4 4 4 4 4 4 4 4 4 4 4 4 4 4 4
 4 4 4 4 4 4 4 4 4 4 4 4 4 4 4 4 4 4 4 4 4 4 4 4 4 4 4 4 4 4]
Model classification result -> 0.7758620689655172 ||| Model classification loss -> 0.22413793103448276
Model Test loss -> 0.9307445883750916 , Model Test accuracy -> 0.7758620977401733
Confusion Matrix -> 
[[ 22   5  19   2   9]
 [  0   9  13   0  19]
 [  1   6 318   1   2]
 [  0   0  46  77   0]
 [  0   0  23  10 114]]
Shape checking X_test image: (696, 64, 64, 3)
Shape checking X_train image: (7, 64, 64, 3)
Prediction_labels: [2 0 1 1 2 2 0 2 0 0 4 0 0 0 2 0 0 0 2 2 0 0 0 0 0 0 0 0 0 0 2 1 1 0 0 4 2
 0 0 2 0 2 4 0 0 2 0 4 2 2 4 0 2 0 4 2 0 4 4 4 4 4 4 0 4 4 1 2 2 4 4 4 4 2
 0 4 4 0 1 4 4 2 2 2 2 1 1 4 0 4 1 2 0 4 1 4 2 2 2 2 2 2 2 2 2 2 2 2 2 2 2
 2 2 2 2 2 1 2 2 2 2 2 2 2 2 2 2 2 2 2 2 2 4 2 2 1 2 2 2 2 2 2 2 2 2 2 2 2
 2 2 2 2 2 2 2 2 2 2 2 2 2 2 2 2 2 2 2 2 2 2 2 2 2 2 2 2 2 2 2 2 2 2 2 2 2
 2 2 2 2 1 2 2 2 2 2 2 2 2 1 2 2 1 2 2 2 2 2 2 2 2 2 2 2 2 2 1 2 2 2 2 2 2
 2 2 2 2 2 2 2 2 2 2 2 2 2 2 2 2 2 2 2 2 2 0 2 2 2 2 2 2 2 2 2 2 2 2 2 2 2
 2 2 2 2 2 2 2 2 2 2 2 2 2 2 2 2 2 0 2 2 2 2 2 2 2 2 2 2 2 1 2 2 2 2 2 2 2
 2 2 2 2 2 2 2 2 2 2 2 2 2 2 2 2 2 2 2 2 2 2 2 2 2 2 2 2 2 2 2 2 1 2 2 2 2
 2 2 2 2 2 2 2 2 2 2 2 2 2 2 2 2 2 2 2 2 2 2 2 1 2 2 2 2 2 2 2 2 2 2 2 2 2
 2 2 2 2 2 2 2 2 2 4 2 2 2 2 2 2 2 2 2 2 2 2 2 2 2 2 2 2 2 2 2 2 2 2 2 2 2
 2 2 2 2 2 2 2 2 2 1 2 2 2 2 2 2 2 2 2 3 3 3 3 2 2 2 3 3 3 3 2 2 2 3 2 2 3
 3 3 3 2 2 3 2 2 3 3 3 3 3 3 2 2 2 2 2 2 2 2 2 2 2 2 2 2 2 2 2 3 2 3 2 2 3
 2 2 2 2 2 2 2 2 2 3 2 2 2 2 2 2 2 3 3 3 3 3 3 2 3 2 2 3 2 2 2 2 3 3 3 3 3
 2 3 2 2 3 2 2 2 2 2 2 3 3 2 2 2 2 2 2 2 2 2 3 3 3 3 2 2 2 2 3 4 4 4 4 4 4
 2 4 4 4 4 4 4 4 2 2 4 4 4 4 4 4 4 2 4 4 4 4 4 4 4 4 4 4 4 4 4 4 4 4 2 4 4
 4 4 4 4 4 4 4 4 4 4 4 2 4 4 4 4 4 4 4 4 4 4 4 4 4 4 4 4 4 4 4 4 4 4 4 4 4
 4 4 4 4 4 4 4 4 4 4 4 4 4 4 4 4 4 4 4 4 4 4 4 4 4 4 4 4 4 4 4 4 2 4 4 4 4
 4 1 4 4 4 4 2 2 4 4 4 1 4 4 4 4 4 4 4 4 4 4 4 4 4 4 4 4 4 4]
Test_labels: [0 0 0 0 0 0 0 0 0 0 0 0 0 0 0 0 0 0 0 0 0 0 0 0 0 0 0 0 0 0 0 0 0 0 0 0 0
 0 0 0 0 0 0 0 0 0 0 0 0 0 0 0 0 0 0 0 0 1 1 1 1 1 1 1 1 1 1 1 1 1 1 1 1 1
 1 1 1 1 1 1 1 1 1 1 1 1 1 1 1 1 1 1 1 1 1 1 1 1 2 2 2 2 2 2 2 2 2 2 2 2 2
 2 2 2 2 2 2 2 2 2 2 2 2 2 2 2 2 2 2 2 2 2 2 2 2 2 2 2 2 2 2 2 2 2 2 2 2 2
 2 2 2 2 2 2 2 2 2 2 2 2 2 2 2 2 2 2 2 2 2 2 2 2 2 2 2 2 2 2 2 2 2 2 2 2 2
 2 2 2 2 2 2 2 2 2 2 2 2 2 2 2 2 2 2 2 2 2 2 2 2 2 2 2 2 2 2 2 2 2 2 2 2 2
 2 2 2 2 2 2 2 2 2 2 2 2 2 2 2 2 2 2 2 2 2 2 2 2 2 2 2 2 2 2 2 2 2 2 2 2 2
 2 2 2 2 2 2 2 2 2 2 2 2 2 2 2 2 2 2 2 2 2 2 2 2 2 2 2 2 2 2 2 2 2 2 2 2 2
 2 2 2 2 2 2 2 2 2 2 2 2 2 2 2 2 2 2 2 2 2 2 2 2 2 2 2 2 2 2 2 2 2 2 2 2 2
 2 2 2 2 2 2 2 2 2 2 2 2 2 2 2 2 2 2 2 2 2 2 2 2 2 2 2 2 2 2 2 2 2 2 2 2 2
 2 2 2 2 2 2 2 2 2 2 2 2 2 2 2 2 2 2 2 2 2 2 2 2 2 2 2 2 2 2 2 2 2 2 2 2 2
 2 2 2 2 2 2 2 2 2 2 2 2 2 2 2 2 2 2 2 3 3 3 3 3 3 3 3 3 3 3 3 3 3 3 3 3 3
 3 3 3 3 3 3 3 3 3 3 3 3 3 3 3 3 3 3 3 3 3 3 3 3 3 3 3 3 3 3 3 3 3 3 3 3 3
 3 3 3 3 3 3 3 3 3 3 3 3 3 3 3 3 3 3 3 3 3 3 3 3 3 3 3 3 3 3 3 3 3 3 3 3 3
 3 3 3 3 3 3 3 3 3 3 3 3 3 3 3 3 3 3 3 3 3 3 3 3 3 3 3 3 3 3 3 4 4 4 4 4 4
 4 4 4 4 4 4 4 4 4 4 4 4 4 4 4 4 4 4 4 4 4 4 4 4 4 4 4 4 4 4 4 4 4 4 4 4 4
 4 4 4 4 4 4 4 4 4 4 4 4 4 4 4 4 4 4 4 4 4 4 4 4 4 4 4 4 4 4 4 4 4 4 4 4 4
 4 4 4 4 4 4 4 4 4 4 4 4 4 4 4 4 4 4 4 4 4 4 4 4 4 4 4 4 4 4 4 4 4 4 4 4 4
 4 4 4 4 4 4 4 4 4 4 4 4 4 4 4 4 4 4 4 4 4 4 4 4 4 4 4 4 4 4]
Model classification result -> 0.7658045977011494 ||| Model classification loss -> 0.23419540229885058
Model Test loss -> 0.8397079110145569 , Model Test accuracy -> 0.7658045887947083
Confusion Matrix -> 
[[ 31   4  16   0   6]
 [  5   6  10   0  20]
 [  2  10 314   0   2]
 [  0   0  77  46   0]
 [  0   2   9   0 136]]
